#################################
#A#     #     #       #       # #
# ### ### ### # ##### # ##### # #
#   #     #   #     # #     #   #
### ##### # ######### ####### ###
#   #     #             #       #
# ### ######### ### ### # #######
#     #       #   #   # #       #
##### # ##### ### # # # ####### #
#   # #     #     # # #       # #
# # # ##### ##### # # ####### # #
# # #     #     # # #       #   #
# # ##### ### ### # ######### ###
# #     #   #   # #         #   #
# ##### ### ### # ######### ### #
#     #         #       #       #
### ######### ######### ####### #
#   #       #         #       # #
# ######### ######### # ##### # #
#         #                   #B#
#################################